{
  "甲": {
    "甲": "貫索",
    "乙": "石門",
    "丙": "鳳閣",
    "丁": "調舒",
    "戊": "龍高",
    "己": "玉堂",
    "庚": "禄存",
    "辛": "司禄",
    "壬": "車騎",
    "癸": "牽牛"
  },
  "乙": {
    "甲": "石門",
    "乙": "貫索",
    "丙": "調舒",
    "丁": "鳳閣",
    "戊": "玉堂",
    "己": "龍高",
    "庚": "司禄",
    "辛": "禄存",
    "壬": "牽牛",
    "癸": "車騎"
  },
  "丙": {
    "甲": "鳳閣",
    "乙": "調舒",
    "丙": "貫索",
    "丁": "石門",
    "戊": "禄存",
    "己": "司禄",
    "庚": "龍高",
    "辛": "玉堂",
    "壬": "鳳閣",
    "癸": "調舒"
  },
  "丁": {
    "甲": "調舒",
    "乙": "鳳閣",
    "丙": "石門",
    "丁": "貫索",
    "戊": "司禄",
    "己": "禄存",
    "庚": "玉堂",
    "辛": "龍高",
    "壬": "調舒",
    "癸": "鳳閣"
  },
  "戊": {
    "甲": "龍高",
    "乙": "玉堂",
    "丙": "禄存",
    "丁": "司禄",
    "戊": "貫索",
    "己": "石門",
    "庚": "鳳閣",
    "辛": "調舒",
    "壬": "龍高",
    "癸": "玉堂"
  },
  "己": {
    "甲": "玉堂",
    "乙": "龍高",
    "丙": "司禄",
    "丁": "禄存",
    "戊": "石門",
    "己": "貫索",
    "庚": "調舒",
    "辛": "鳳閣",
    "壬": "玉堂",
    "癸": "龍高"
  },
  "庚": {
    "甲": "禄存",
    "乙": "司禄",
    "丙": "龍高",
    "丁": "玉堂",
    "戊": "鳳閣",
    "己": "調舒",
    "庚": "貫索",
    "辛": "石門",
    "壬": "禄存",
    "癸": "司禄"
  },
  "辛": {
    "甲": "司禄",
    "乙": "禄存",
    "丙": "玉堂",
    "丁": "龍高",
    "戊": "調舒",
    "己": "鳳閣",
    "庚": "石門",
    "辛": "貫索",
    "壬": "司禄",
    "癸": "禄存"
  },
  "壬": {
    "甲": "車騎",
    "乙": "牽牛",
    "丙": "鳳閣",
    "丁": "調舒",
    "戊": "龍高",
    "己": "玉堂",
    "庚": "禄存",
    "辛": "司禄",
    "壬": "貫索",
    "癸": "石門"
  },
  "癸": {
    "甲": "牽牛",
    "乙": "車騎",
    "丙": "調舒",
    "丁": "鳳閣",
    "戊": "玉堂",
    "己": "龍高",
    "庚": "司禄",
    "辛": "禄存",
    "壬": "石門",
    "癸": "貫索"
  }
}
